Dungeon Name: Noah 2 - 48x48
Next Dungeon Name: Noah 3 - 48x48
Dungeon Size: 48, 48
w0 w0 w0 w0 w0 w0 w0 w0 w0 w0 w0 w0 w0 w0 w0 w0 w0 w0 w0 w0 w0 w0 w0 w0 w0 w0 w0 w0 w0 w0 w0 w0 w0 w0 w0 w0 w0 w0 w0 w0 w0 w0 w0 w0 w0 w0 w0 w0 
w0 w0 w0 w0 w0 w0 w0 w0 w0 w0 w0 w0 w0 w0 w0 w0 w0 w0 w0 w0 w0 w0 w0 w0 w0 w0 w0 w0 w0 -- -- -- -- -- -- -- -- -- w0 w0 w0 w0 w0 w0 w0 w0 w0 w0 
w0 w0 w0 w0 w0 w0 w0 w0 w0 w0 w0 w0 w0 w0 w0 w0 w0 w0 w0 w0 w0 w0 w0 w0 w0 w0 w0 w0 w0 -- -- -- -- -- -- -- -- -- w0 w0 w0 w0 w0 w0 w0 w0 w0 w0 
w0 w0 w0 w0 w0 w0 w0 w0 w0 w0 w0 w0 w0 w0 w0 w0 w0 w0 w0 w0 w0 w0 w0 w0 w0 w0 w0 w0 w0 -- -- -- -- -- -- -- -- -- w0 w0 w0 w0 w0 w0 w0 w0 w0 w0 
w0 w0 w0 w0 w0 w0 w0 w0 w0 w0 w0 w0 w0 w0 w0 w0 w0 w0 w0 w0 w0 w0 w0 w0 w0 w0 w0 w0 w0 -- -- -- -- -- -- -- -- -- w0 w0 w0 w0 w0 w0 w0 w0 w0 w0 
w0 w0 w0 w0 w0 w0 w0 w0 w0 w0 w0 w0 w0 w0 w0 w0 w0 w0 w0 w0 w0 w0 w0 w0 w0 w0 w0 w0 w0 -- -- -- -- -- -- -- -- -- w0 w0 w0 w0 w0 w0 w0 w0 w0 w0 
w0 w0 w0 w0 w0 w0 w0 w0 w0 w0 w0 w0 w0 w0 w0 w0 w0 w0 w0 w0 w0 w0 w0 w0 w0 w0 w0 w0 w0 -- -- -- -- -- -- -- -- -- w0 w0 w0 w0 w0 w0 w0 w0 w0 w0 
w0 -- -- -- -- -- -- -- -- -- -- -- -- -- -- -- -- -- -- -- -- -- -- -- -- -- -- -- -- -- -- -- -- -- -- -- -- -- w0 w0 w0 w0 w0 w0 w0 w0 w0 w0 
w0 -- -- -- -- -- -- -- -- -- -- -- -- -- -- -- -- -- -- -- -- -- -- -- -- -- -- -- -- -- -- -- -- -- -- -- -- -- w0 w0 w0 w0 w0 w0 w0 w0 w0 w0 
w0 -- -- -- -- -- -- -- -- -- -- -- -- -- -- -- -- -- -- -- -- -- -- -- -- -- -- -- -- -- -- -- -- -- -- -- -- -- w0 w0 w0 w0 w0 w0 w0 w0 w0 w0 
w0 -- -- -- -- -- -- -- -- -- -- -- -- -- -- -- -- -- -- -- -- -- -- -- -- -- -- -- -- -- -- -- -- -- -- -- -- -- w0 w0 w0 w0 w0 w0 w0 w0 w0 w0 
w0 -- -- -- -- -- -- -- -- -- -- -- -- -- -- -- -- -- -- -- w0 w0 w0 w0 w0 w0 w0 w0 w0 -- -- -- -- -- -- -- -- -- w0 w0 w0 w0 w0 w0 w0 w0 w0 w0 
w0 -- -- -- -- -- -- -- -- -- -- -- -- -- -- -- -- -- -- -- w0 w0 w0 w0 w0 w0 w0 w0 w0 -- -- -- -- -- -- -- -- -- w0 w0 w0 w0 w0 w0 w0 w0 w0 w0 
w0 -- -- -- -- -- -- -- -- -- -- -- -- -- -- -- -- -- -- -- w0 w0 w0 w0 w0 w0 w0 w0 w0 -- -- -- -- -- -- -- -- -- w0 w0 w0 w0 w0 w0 w0 w0 w0 w0 
w0 -- -- -- -- -- -- -- -- -- -- -- -- -- -- -- -- -- -- -- w0 w0 w0 w0 w0 w0 w0 w0 w0 -- -- -- -- -- -- -- -- -- w0 w0 w0 w0 w0 w0 w0 w0 w0 w0 
w0 -- -- -- -- -- -- -- -- -- -- -- -- -- -- -- -- -- -- -- w0 w0 w0 w0 w0 w0 w0 w0 w0 -- -- -- -- -- -- -- -- -- w0 w0 w0 w0 w0 w0 w0 w0 w0 w0 
w0 -- -- -- -- -- -- -- -- -- -- -- -- -- -- -- -- -- -- -- w0 w0 w0 w0 w0 w0 w0 w0 w0 -- -- -- -- -- -- -- -- -- w0 w0 w0 w0 w0 w0 w0 w0 w0 w0 
w0 -- -- -- -- -- -- -- -- -- -- -- -- -- -- -- -- -- -- -- w0 w0 w0 w0 w0 w0 w0 w0 w0 -- -- -- -- -- -- -- -- -- w0 w0 w0 w0 w0 w0 w0 w0 w0 w0 
w0 -- -- -- -- -- -- -- -- -- -- -- -- -- -- -- -- -- -- -- w0 w0 w0 w0 w0 w0 w0 w0 w0 -- -- -- -- -- -- -- -- -- w0 w0 w0 w0 w0 w0 w0 w0 w0 w0 
w0 -- -- -- -- w0 w0 w0 w0 w0 w0 w0 w0 w0 w0 w0 w0 w0 w0 w0 w0 w0 w0 w0 w0 w0 w0 w0 w0 -- -- -- -- -- -- -- -- -- w0 w0 w0 w0 w0 w0 w0 w0 w0 w0 
w0 -- -- -- -- w0 w0 w0 w0 w0 w0 w0 w0 w0 w0 w0 w0 w0 w0 w0 w0 w0 w0 w0 w0 w0 w0 w0 w0 -- -- -- -- -- -- -- -- -- w0 w0 w0 w0 w0 w0 w0 w0 w0 w0 
w0 -- -- -- -- w0 w0 w0 w0 w0 w0 w0 w0 w0 w0 w0 w0 w0 w0 w0 w0 w0 w0 w0 w0 w0 w0 w0 w0 -- -- -- -- -- -- -- -- -- w0 w0 w0 w0 w0 w0 w0 w0 w0 w0 
w0 -- -- -- -- w0 w0 w0 w0 w0 w0 w0 w0 w0 w0 w0 w0 w0 w0 w0 w0 w0 w0 w0 w0 w0 w0 w0 w0 -- -- -- -- -- -- -- -- -- w0 w0 w0 w0 w0 w0 w0 w0 w0 w0 
w0 -- -- -- -- w0 w0 w0 w0 w0 w0 w0 w0 w0 w0 w0 w0 w0 w0 w0 w0 w0 w0 w0 w0 w0 w0 w0 w0 -- -- -- -- -- -- -- -- -- w0 w0 w0 w0 w0 w0 w0 w0 w0 w0 
w0 -- -- -- -- w0 w0 w0 w0 w0 w0 w0 w0 w0 w0 w0 w0 w0 w0 w0 w0 w0 w0 w0 w0 w0 w0 w0 w0 -- -- -- -- -- -- -- -- -- w0 w0 w0 w0 w0 w0 w0 w0 w0 w0 
w0 -- -- -- -- w0 w0 w0 w0 w0 w0 w0 w0 w0 w0 w0 w0 w0 w0 w0 w0 w0 w0 w0 w0 w0 w0 w0 w0 -- -- -- -- -- -- -- -- -- w0 w0 w0 w0 w0 w0 w0 w0 w0 w0 
w0 -- -- -- -- w0 w0 w0 w0 w0 w0 w0 w0 w0 w0 w0 w0 w0 w0 w0 w0 w0 w0 w0 w0 w0 w0 w0 w0 -- -- -- -- -- -- -- -- -- w0 w0 w0 w0 w0 w0 w0 w0 w0 w0 
w0 -- -- -- -- -- -- -- -- -- -- -- -- -- -- -- -- -- -- -- -- -- -- -- -- -- -- -- -- -- -- -- -- -- -- -- -- -- w0 w0 w0 w0 w0 w0 w0 w0 w0 w0 
w0 -- -- -- -- -- -- -- -- -- -- -- -- -- -- -- -- -- -- -- -- -- -- -- -- -- -- -- -- -- -- -- -- -- -- -- -- -- w0 w0 w0 w0 w0 w0 w0 w0 w0 w0 
w0 -- -- -- -- -- -- -- -- -- -- -- -- -- -- -- -- -- -- -- -- -- -- -- -- -- -- -- -- -- -- -- -- -- -- -- -- -- w0 w0 w0 w0 w0 w0 w0 w0 w0 w0 
w0 -- -- -- -- -- -- -- -- -- -- -- -- -- -- -- -- -- -- -- -- -- -- -- -- -- -- -- -- -- -- -- -- -- -- -- -- -- w0 w0 w0 w0 w0 w0 w0 w0 w0 w0 
w0 -- -- -- -- -- -- -- -- -- -- -- -- -- -- -- -- -- -- -- -- -- -- -- -- -- -- -- -- -- -- -- -- -- -- -- -- -- w0 w0 w0 w0 w0 w0 w0 w0 w0 w0 
w0 -- -- -- -- -- -- -- -- -- -- -- -- -- -- -- -- -- -- -- -- -- -- -- -- -- -- -- -- -- -- -- -- -- -- -- -- -- w0 w0 w0 w0 w0 w0 w0 w0 w0 w0 
w0 -- -- -- -- -- -- -- -- -- -- -- -- -- -- -- -- -- -- -- -- -- -- -- -- -- -- -- -- -- -- -- -- -- -- -- -- -- w0 w0 w0 w0 w0 w0 w0 w0 w0 w0 
w0 -- -- -- -- -- -- -- -- -- -- -- -- -- -- -- -- -- -- -- -- -- -- -- -- -- -- -- -- -- -- -- -- -- -- -- -- -- w0 w0 w0 w0 w0 w0 w0 w0 w0 w0 
w0 -- -- -- -- -- -- -- -- -- -- -- -- -- -- -- -- -- -- -- -- -- -- -- -- -- -- -- -- -- -- -- -- -- -- -- -- -- w0 w0 w0 w0 w0 w0 w0 w0 w0 w0 
w0 -- -- -- -- -- -- -- -- -- -- -- -- -- -- -- -- -- -- -- -- -- -- -- -- -- -- -- -- -- -- -- -- -- -- -- -- -- w0 w0 w0 w0 w0 w0 w0 w0 w0 w0 
w0 -- -- -- -- -- -- -- w0 w0 w0 w0 w0 w0 w0 w0 w0 w0 w0 w0 w0 w0 w0 w0 w0 w0 w0 w0 w0 w0 w0 w0 w0 w0 w0 w0 w0 w0 w0 w0 w0 w0 w0 w0 w0 w0 w0 w0 
w0 -- -- -- -- -- -- -- w0 w0 w0 w0 w0 w0 w0 w0 w0 w0 w0 w0 w0 w0 w0 w0 w0 w0 w0 w0 w0 w0 w0 w0 w0 w0 w0 w0 w0 w0 w0 w0 w0 w0 w0 w0 w0 w0 w0 w0 
w0 -- -- -- -- -- -- -- w0 w0 w0 w0 w0 w0 w0 w0 w0 w0 w0 w0 w0 w0 w0 w0 w0 w0 w0 w0 w0 w0 w0 w0 w0 w0 w0 w0 w0 w0 w0 w0 w0 w0 w0 w0 w0 w0 w0 w0 
w0 -- -- -- -- -- -- -- w0 w0 w0 w0 w0 w0 w0 w0 w0 w0 w0 w0 w0 w0 w0 w0 w0 w0 w0 w0 w0 w0 w0 w0 w0 w0 w0 w0 w0 w0 w0 w0 w0 w0 w0 w0 w0 w0 w0 w0 
w0 -- -- -- -- -- -- -- w0 w0 w0 w0 w0 w0 w0 w0 w0 w0 w0 w0 w0 w0 w0 w0 w0 w0 w0 w0 w0 w0 w0 w0 w0 w0 w0 w0 w0 w0 w0 w0 w0 w0 w0 w0 w0 w0 w0 w0 
w0 -- -- -- -- -- -- -- w0 w0 w0 w0 w0 w0 w0 w0 w0 w0 w0 w0 w0 w0 w0 w0 w0 w0 w0 w0 w0 w0 w0 w0 w0 w0 w0 w0 w0 w0 w0 w0 w0 w0 w0 w0 w0 w0 w0 w0 
w0 -- -- -- -- -- -- -- w0 w0 w0 w0 w0 w0 w0 w0 w0 w0 w0 w0 w0 w0 w0 w0 w0 w0 w0 w0 w0 w0 w0 w0 w0 w0 w0 w0 w0 w0 w0 w0 w0 w0 w0 w0 w0 w0 w0 w0 
w0 -- -- -- -- -- -- -- w0 w0 w0 w0 w0 w0 w0 w0 w0 w0 w0 w0 w0 w0 w0 w0 w0 w0 w0 w0 w0 w0 w0 w0 w0 w0 w0 w0 w0 w0 w0 w0 w0 w0 w0 w0 w0 w0 w0 w0 
w0 -- -- -- -- -- -- -- w0 w0 w0 w0 w0 w0 w0 w0 w0 w0 w0 w0 w0 w0 w0 w0 w0 w0 w0 w0 w0 w0 w0 w0 w0 w0 w0 w0 w0 w0 w0 w0 w0 w0 w0 w0 w0 w0 w0 w0 
w0 -- -- -- -- -- -- -- w0 w0 w0 w0 w0 w0 w0 w0 w0 w0 w0 w0 w0 w0 w0 w0 w0 w0 w0 w0 w0 w0 w0 w0 w0 w0 w0 w0 w0 w0 w0 w0 w0 w0 w0 w0 w0 w0 w0 w0 
w0 w0 w0 w0 w0 w0 w0 w0 w0 w0 w0 w0 w0 w0 w0 w0 w0 w0 w0 w0 w0 w0 w0 w0 w0 w0 w0 w0 w0 w0 w0 w0 w0 w0 w0 w0 w0 w0 w0 w0 w0 w0 w0 w0 w0 w0 w0 w0 
end-dungeon
Enemies on Level
-- -- -- -- -- -- -- -- -- -- -- -- -- -- -- -- -- -- -- -- -- -- -- -- -- -- -- -- -- -- -- -- -- -- -- -- -- -- -- -- -- -- -- -- -- -- -- -- 
-- -- -- -- -- -- -- -- -- -- -- -- -- -- -- -- -- -- -- -- -- -- -- -- -- -- -- -- -- -- -- -- -- -- -- -- -- -- -- -- -- -- -- -- -- -- -- -- 
-- -- -- -- -- -- -- -- -- -- -- -- -- -- -- -- -- -- -- -- -- -- -- -- -- -- -- -- -- -- -- -- -- -- -- -- -- -- -- -- -- -- -- -- -- -- -- -- 
-- -- -- -- -- -- -- -- -- -- -- -- -- -- -- -- -- -- -- -- -- -- -- -- -- -- -- -- -- -- -- -- -- -- -- -- -- -- -- -- -- -- -- -- -- -- -- -- 
-- -- -- -- -- -- -- -- -- -- -- -- -- -- -- -- -- -- -- -- -- -- -- -- -- -- -- -- -- -- -- -- -- -- -- -- -- -- -- -- -- -- -- -- -- -- -- -- 
-- -- -- -- -- -- -- -- -- -- -- -- -- -- -- -- -- -- -- -- -- -- -- -- -- -- -- -- -- -- -- -- -- -- -- -- -- -- -- -- -- -- -- -- -- -- -- -- 
-- -- -- -- -- -- -- -- -- -- -- -- -- -- -- -- -- -- -- -- -- -- -- -- -- -- -- -- -- -- -- -- -- -- -- -- -- -- -- -- -- -- -- -- -- -- -- -- 
-- -- -- -- -- -- -- -- -- -- -- -- -- -- -- -- -- -- -- -- -- -- -- -- -- -- -- -- -- -- -- -- -- -- -- -- -- -- -- -- -- -- -- -- -- -- -- -- 
-- -- -- -- -- -- -- -- -- -- -- -- -- -- -- -- -- -- -- -- -- -- -- -- -- -- -- -- -- -- -- -- -- -- -- -- -- -- -- -- -- -- -- -- -- -- -- -- 
-- -- -- -- -- -- -- -- -- -- -- -- -- -- -- -- -- -- -- -- -- -- -- -- -- -- -- -- -- -- -- -- -- -- -- -- -- -- -- -- -- -- -- -- -- -- -- -- 
-- -- -- -- -- -- -- -- -- -- -- -- -- -- -- -- -- -- -- -- -- -- -- -- -- -- -- -- -- -- -- -- -- -- -- -- -- -- -- -- -- -- -- -- -- -- -- -- 
-- -- -- -- -- -- -- -- -- -- -- -- -- -- -- -- -- -- -- -- -- -- -- -- -- -- -- -- -- -- -- -- -- -- -- -- -- -- -- -- -- -- -- -- -- -- -- -- 
-- -- -- -- -- -- -- -- -- -- -- -- -- -- -- -- -- -- -- -- -- -- -- -- -- -- -- -- -- -- -- -- -- -- -- -- -- -- -- -- -- -- -- -- -- -- -- -- 
-- -- -- -- -- -- -- -- -- -- -- -- -- -- -- -- -- -- -- -- -- -- -- -- -- -- -- -- -- -- -- -- -- -- -- -- -- -- -- -- -- -- -- -- -- -- -- -- 
-- -- -- -- -- -- -- -- -- -- -- -- -- -- -- -- -- -- -- -- -- -- -- -- -- -- -- -- -- -- -- -- -- -- -- -- -- -- -- -- -- -- -- -- -- -- -- -- 
-- -- -- -- -- -- -- -- -- e1 -- -- -- -- -- -- -- -- -- -- -- -- -- -- -- -- -- -- -- -- -- -- -- -- -- -- -- -- -- -- -- -- -- -- -- -- -- -- 
-- -- -- -- -- -- -- -- -- -- -- -- -- -- -- -- -- -- -- -- -- -- -- -- -- -- -- -- -- -- -- -- -- -- -- -- -- -- -- -- -- -- -- -- -- -- -- -- 
-- -- -- -- -- -- -- -- -- -- -- -- -- -- -- -- -- -- -- -- -- -- -- -- -- -- -- -- -- -- -- -- -- -- -- -- -- -- -- -- -- -- -- -- -- -- -- -- 
-- -- -- -- -- -- -- -- -- -- -- -- -- -- -- -- -- -- -- -- -- -- -- -- -- -- -- -- -- -- -- -- -- -- -- -- -- -- -- -- -- -- -- -- -- -- -- -- 
-- -- -- -- -- -- -- -- -- -- -- -- -- -- -- -- -- -- -- -- -- -- -- -- -- -- -- -- -- -- -- -- -- -- -- -- -- -- -- -- -- -- -- -- -- -- -- -- 
-- -- -- -- -- -- -- -- -- -- -- -- -- -- -- -- -- -- -- -- -- -- -- -- -- -- -- -- -- -- -- -- -- -- -- -- -- -- -- -- -- -- -- -- -- -- -- -- 
-- -- -- -- -- -- -- -- -- -- -- -- -- -- -- -- -- -- -- -- -- -- -- -- -- -- -- -- -- -- -- -- -- -- -- -- -- -- -- -- -- -- -- -- -- -- -- -- 
-- -- -- -- -- -- -- -- -- -- -- -- -- -- -- -- -- -- -- -- -- -- -- -- -- -- -- -- -- -- -- -- -- -- -- -- -- -- -- -- -- -- -- -- -- -- -- -- 
-- -- -- -- -- -- -- -- -- -- -- -- -- -- -- -- -- -- -- -- -- -- -- -- -- -- -- -- -- -- -- -- -- -- -- -- -- -- -- -- -- -- -- -- -- -- -- -- 
-- -- -- -- -- -- -- -- -- -- -- -- -- -- -- -- -- -- -- -- -- -- -- -- -- -- -- -- -- -- -- -- -- -- -- -- -- -- -- -- -- -- -- -- -- -- -- -- 
-- -- -- -- -- -- -- -- -- -- -- -- -- -- -- -- -- -- -- -- -- -- -- -- -- -- -- -- -- -- -- -- -- -- -- -- -- -- -- -- -- -- -- -- -- -- -- -- 
-- -- -- -- -- -- -- -- -- -- -- -- -- -- -- -- -- -- -- -- -- -- -- -- -- -- -- -- -- -- -- -- -- -- -- -- -- -- -- -- -- -- -- -- -- -- -- -- 
-- -- -- -- -- -- -- -- -- -- -- -- -- -- -- -- -- -- -- -- -- -- -- -- -- -- -- -- -- -- -- -- -- -- -- -- -- -- -- -- -- -- -- -- -- -- -- -- 
-- -- -- -- -- -- -- -- -- -- -- -- -- -- -- -- -- -- -- -- -- -- -- -- -- -- -- -- -- -- -- -- -- -- -- -- -- -- -- -- -- -- -- -- -- -- -- -- 
-- -- -- -- -- -- -- -- -- -- -- -- -- -- -- -- -- -- -- -- -- -- -- -- -- -- -- -- -- -- -- -- -- -- -- -- -- -- -- -- -- -- -- -- -- -- -- -- 
-- -- -- -- -- -- -- -- -- -- -- -- -- -- -- -- -- -- -- -- -- -- -- -- -- -- -- -- -- -- -- -- -- -- -- -- -- -- -- -- -- -- -- -- -- -- -- -- 
-- -- -- -- -- -- -- -- -- -- -- -- -- -- -- -- -- -- -- -- -- -- -- -- -- -- e2 -- -- -- -- -- -- -- -- -- -- -- -- -- -- -- -- -- -- -- -- -- 
-- -- -- -- -- -- -- -- -- -- -- -- -- -- -- -- -- -- -- -- -- -- -- -- -- -- -- -- -- -- -- -- -- -- -- -- -- -- -- -- -- -- -- -- -- -- -- -- 
-- -- -- -- -- -- -- -- -- -- -- -- -- -- -- -- -- -- -- -- -- -- -- -- -- -- -- -- -- -- -- -- -- -- -- -- -- -- -- -- -- -- -- -- -- -- -- -- 
-- -- -- -- -- -- -- -- -- -- -- -- -- -- -- -- -- -- -- -- -- -- -- -- -- -- -- -- -- -- -- -- -- -- -- -- -- -- -- -- -- -- -- -- -- -- -- -- 
-- -- -- -- -- -- -- -- -- -- -- -- -- -- -- -- -- -- -- -- -- -- -- -- -- -- -- -- -- -- -- -- -- -- -- -- -- -- -- -- -- -- -- -- -- -- -- -- 
-- -- -- -- -- -- -- -- -- -- -- -- -- -- -- -- -- -- -- -- -- -- -- -- -- -- -- -- -- -- -- -- -- -- -- -- -- -- -- -- -- -- -- -- -- -- -- -- 
-- -- -- -- -- -- -- -- -- -- -- -- -- -- -- -- -- -- -- -- -- -- -- -- -- -- -- -- -- -- -- -- -- -- -- -- -- -- -- -- -- -- -- -- -- -- -- -- 
-- -- -- -- -- -- -- -- -- -- -- -- -- -- -- -- -- -- -- -- -- -- -- -- -- -- -- -- -- -- -- -- -- -- -- -- -- -- -- -- -- -- -- -- -- -- -- -- 
-- -- -- -- -- -- -- -- -- -- -- -- -- -- -- -- -- -- -- -- -- -- -- -- -- -- -- -- -- -- -- -- -- -- -- -- -- -- -- -- -- -- -- -- -- -- -- -- 
-- -- -- -- -- -- -- -- -- -- -- -- -- -- -- -- -- -- -- -- -- -- -- -- -- -- -- -- -- -- -- -- -- -- -- -- -- -- -- -- -- -- -- -- -- -- -- -- 
-- -- -- e3 -- -- -- -- -- -- -- -- -- -- -- -- -- -- -- -- -- -- -- -- -- -- -- -- -- -- -- -- -- -- -- -- -- -- -- -- -- -- -- -- -- -- -- -- 
-- -- -- -- -- -- -- -- -- -- -- -- -- -- -- -- -- -- -- -- -- -- -- -- -- -- -- -- -- -- -- -- -- -- -- -- -- -- -- -- -- -- -- -- -- -- -- -- 
-- -- -- -- -- -- -- -- -- -- -- -- -- -- -- -- -- -- -- -- -- -- -- -- -- -- -- -- -- -- -- -- -- -- -- -- -- -- -- -- -- -- -- -- -- -- -- -- 
-- -- -- -- -- -- -- -- -- -- -- -- -- -- -- -- -- -- -- -- -- -- -- -- -- -- -- -- -- -- -- -- -- -- -- -- -- -- -- -- -- -- -- -- -- -- -- -- 
-- -- -- -- -- -- -- -- -- -- -- -- -- -- -- -- -- -- -- -- -- -- -- -- -- -- -- -- -- -- -- -- -- -- -- -- -- -- -- -- -- -- -- -- -- -- -- -- 
-- -- -- -- -- -- -- -- -- -- -- -- -- -- -- -- -- -- -- -- -- -- -- -- -- -- -- -- -- -- -- -- -- -- -- -- -- -- -- -- -- -- -- -- -- -- -- -- 
-- -- -- -- -- -- -- -- -- -- -- -- -- -- -- -- -- -- -- -- -- -- -- -- -- -- -- -- -- -- -- -- -- -- -- -- -- -- -- -- -- -- -- -- -- -- -- -- 
end-enemy-loc
EnemiesStatistics
e1,Elemont2,15,15
e2,Elemont,15,15
e3,Elemont,15,15
end-enemy
Items on level
-- -- -- -- -- -- -- -- -- -- -- -- -- -- -- -- -- -- -- -- -- -- -- -- -- -- -- -- -- -- -- -- -- -- -- -- -- -- -- -- -- -- -- -- -- -- -- -- 
-- -- -- -- -- -- -- -- -- -- -- -- -- -- -- -- -- -- -- -- -- -- -- -- -- -- -- -- -- -- -- -- -- -- -- -- -- -- -- -- -- -- -- -- -- -- -- -- 
-- -- -- -- -- -- -- -- -- -- -- -- -- -- -- -- -- -- -- -- -- -- -- -- -- -- -- -- -- -- -- -- -- -- -- -- -- -- -- -- -- -- -- -- -- -- -- -- 
-- -- -- -- -- -- -- -- -- -- -- -- -- -- -- -- -- -- -- -- -- -- -- -- -- -- -- -- -- -- -- -- -- -- -- -- -- -- -- -- -- -- -- -- -- -- -- -- 
-- -- -- -- -- -- -- -- -- -- -- -- -- -- -- -- -- -- -- -- -- -- -- -- -- -- -- -- -- -- -- -- -- -- -- -- -- -- -- -- -- -- -- -- -- -- -- -- 
-- -- -- -- -- -- -- -- -- -- -- -- -- -- -- -- -- -- -- -- -- -- -- -- -- -- -- -- -- -- -- -- -- -- -- -- -- -- -- -- -- -- -- -- -- -- -- -- 
-- -- -- -- -- -- -- -- -- -- -- -- -- -- -- -- -- -- -- -- -- -- -- -- -- -- -- -- -- -- -- -- -- -- -- -- -- -- -- -- -- -- -- -- -- -- -- -- 
-- -- -- -- -- -- -- -- -- -- -- -- -- -- -- -- -- -- -- -- -- -- -- -- -- -- -- -- -- -- -- -- -- -- -- -- -- -- -- -- -- -- -- -- -- -- -- -- 
-- -- -- -- -- -- -- -- -- -- -- -- -- -- -- -- -- -- -- -- -- -- -- -- -- -- -- -- -- -- -- -- -- -- -- -- -- -- -- -- -- -- -- -- -- -- -- -- 
-- -- -- -- -- -- -- -- -- -- -- -- -- -- -- -- -- -- -- -- -- -- -- -- -- -- -- -- -- -- -- -- -- -- -- -- -- -- -- -- -- -- -- -- -- -- -- -- 
-- -- -- -- -- -- -- -- -- -- -- -- -- -- -- -- -- -- -- -- -- -- -- -- -- -- -- -- -- -- -- -- -- -- -- -- -- -- -- -- -- -- -- -- -- -- -- -- 
-- -- -- -- -- -- -- -- -- -- -- -- -- -- -- -- -- -- -- -- -- -- -- -- -- -- -- -- -- -- -- -- -- -- -- -- -- -- -- -- -- -- -- -- -- -- -- -- 
-- -- -- -- -- -- -- -- -- -- -- -- -- -- -- -- -- -- -- -- -- -- -- -- -- -- -- -- -- -- -- -- -- -- -- -- -- -- -- -- -- -- -- -- -- -- -- -- 
-- -- -- -- -- -- -- -- -- -- -- -- -- -- -- -- -- -- -- -- -- -- -- -- -- -- -- -- -- -- -- -- -- -- -- -- -- -- -- -- -- -- -- -- -- -- -- -- 
-- -- -- -- -- -- -- -- -- -- -- -- -- -- -- -- -- -- -- -- -- -- -- -- -- -- -- -- -- -- -- -- -- -- -- -- -- -- -- -- -- -- -- -- -- -- -- -- 
-- -- -- -- -- -- -- -- -- -- -- -- -- -- -- -- -- -- -- -- -- -- -- -- -- -- -- -- -- -- -- -- -- -- -- -- -- -- -- -- -- -- -- -- -- -- -- -- 
-- -- -- -- -- -- -- -- -- -- -- -- -- -- -- -- -- -- -- -- -- -- -- -- -- -- -- -- -- -- -- -- -- -- -- -- -- -- -- -- -- -- -- -- -- -- -- -- 
-- -- -- -- -- -- -- -- -- -- -- -- -- -- -- -- -- -- -- -- -- -- -- -- -- -- -- -- -- -- -- -- -- -- -- -- -- -- -- -- -- -- -- -- -- -- -- -- 
-- -- -- -- -- -- -- -- -- -- -- -- -- -- -- -- -- -- -- -- -- -- -- -- -- -- -- -- -- -- -- -- -- -- -- -- -- -- -- -- -- -- -- -- -- -- -- -- 
-- -- -- -- -- -- -- -- -- -- -- -- -- -- -- -- -- -- -- -- -- -- -- -- -- -- -- -- -- -- -- -- -- -- -- -- -- -- -- -- -- -- -- -- -- -- -- -- 
-- -- -- -- -- -- -- -- -- -- -- -- -- -- -- -- -- -- -- -- -- -- -- -- -- -- -- -- -- -- -- -- -- -- -- -- -- -- -- -- -- -- -- -- -- -- -- -- 
-- -- -- -- -- -- -- -- -- -- -- -- -- -- -- -- -- -- -- -- -- -- -- -- -- -- -- -- -- -- -- -- -- -- -- -- -- -- -- -- -- -- -- -- -- -- -- -- 
-- -- -- -- -- -- -- -- -- -- -- -- -- -- -- -- -- -- -- -- -- -- -- -- -- -- -- -- -- -- -- -- -- -- -- -- -- -- -- -- -- -- -- -- -- -- -- -- 
-- -- -- -- -- -- -- -- -- -- -- -- -- -- -- -- -- -- -- -- -- -- -- -- -- -- -- -- -- -- -- -- -- -- -- -- -- -- -- -- -- -- -- -- -- -- -- -- 
-- -- -- -- -- -- -- -- -- -- -- -- -- -- -- -- -- -- -- -- -- -- -- -- -- -- -- -- -- -- -- -- -- -- -- -- -- -- -- -- -- -- -- -- -- -- -- -- 
-- -- -- -- -- -- -- -- -- -- -- -- -- -- -- -- -- -- -- -- -- -- -- -- -- -- -- -- -- -- -- -- -- -- -- -- -- -- -- -- -- -- -- -- -- -- -- -- 
-- -- -- -- -- -- -- -- -- -- -- -- -- -- -- -- -- -- -- -- -- -- -- -- -- -- -- -- -- -- -- -- -- -- -- -- -- -- -- -- -- -- -- -- -- -- -- -- 
-- -- -- -- -- -- -- -- -- -- -- -- -- -- -- -- -- -- -- -- -- -- -- -- -- -- -- -- -- -- -- -- -- -- -- -- -- -- -- -- -- -- -- -- -- -- -- -- 
-- -- -- -- -- -- -- -- -- -- -- -- -- -- -- -- -- -- -- -- -- -- -- -- -- -- -- -- -- -- -- -- -- -- -- -- -- -- -- -- -- -- -- -- -- -- -- -- 
-- -- -- -- -- -- -- -- -- -- -- -- -- -- -- -- -- -- -- -- -- -- -- -- -- -- -- -- -- -- -- -- -- -- -- -- -- -- -- -- -- -- -- -- -- -- -- -- 
-- -- -- -- -- -- -- -- -- -- -- -- -- -- -- -- -- -- -- -- -- -- -- -- -- -- -- -- -- -- -- -- -- -- -- -- -- -- -- -- -- -- -- -- -- -- -- -- 
-- -- -- -- -- -- -- -- -- -- -- -- -- -- -- -- -- -- -- -- -- -- -- -- -- -- -- -- -- -- -- -- -- -- -- -- -- -- -- -- -- -- -- -- -- -- -- -- 
-- -- -- -- -- -- -- -- -- -- -- -- -- -- -- -- -- -- -- -- -- -- -- -- -- -- -- -- -- -- -- -- -- -- -- -- -- -- -- -- -- -- -- -- -- -- -- -- 
-- -- -- -- -- -- -- -- -- -- -- -- -- -- -- -- -- -- -- -- -- -- -- -- -- -- -- -- -- -- -- -- -- -- -- -- -- -- -- -- -- -- -- -- -- -- -- -- 
-- -- -- -- -- -- -- -- -- -- -- -- -- -- -- -- -- -- -- -- -- -- -- -- -- -- -- -- -- -- -- -- -- -- -- -- -- -- -- -- -- -- -- -- -- -- -- -- 
-- -- -- -- -- -- -- -- -- -- -- -- -- -- -- -- -- -- -- -- -- -- -- -- -- -- -- -- -- -- -- -- -- -- -- -- -- -- -- -- -- -- -- -- -- -- -- -- 
-- -- -- -- -- -- -- -- -- -- -- -- -- -- -- -- -- -- -- -- -- -- -- -- -- -- -- -- -- -- -- -- -- -- -- -- -- -- -- -- -- -- -- -- -- -- -- -- 
-- -- -- -- -- -- -- -- -- -- -- -- -- -- -- -- -- -- -- -- -- -- -- -- -- -- -- -- -- -- -- -- -- -- -- -- -- -- -- -- -- -- -- -- -- -- -- -- 
-- -- -- -- -- -- -- -- -- -- -- -- -- -- -- -- -- -- -- -- -- -- -- -- -- -- -- -- -- -- -- -- -- -- -- -- -- -- -- -- -- -- -- -- -- -- -- -- 
-- -- -- -- -- -- -- -- -- -- -- -- -- -- -- -- -- -- -- -- -- -- -- -- -- -- -- -- -- -- -- -- -- -- -- -- -- -- -- -- -- -- -- -- -- -- -- -- 
-- -- -- -- -- -- -- -- -- -- -- -- -- -- -- -- -- -- -- -- -- -- -- -- -- -- -- -- -- -- -- -- -- -- -- -- -- -- -- -- -- -- -- -- -- -- -- -- 
-- -- -- -- -- -- -- -- -- -- -- -- -- -- -- -- -- -- -- -- -- -- -- -- -- -- -- -- -- -- -- -- -- -- -- -- -- -- -- -- -- -- -- -- -- -- -- -- 
-- -- -- -- -- -- -- -- -- -- -- -- -- -- -- -- -- -- -- -- -- -- -- -- -- -- -- -- -- -- -- -- -- -- -- -- -- -- -- -- -- -- -- -- -- -- -- -- 
-- -- -- -- -- -- -- -- -- -- -- -- -- -- -- -- -- -- -- -- -- -- -- -- -- -- -- -- -- -- -- -- -- -- -- -- -- -- -- -- -- -- -- -- -- -- -- -- 
-- -- -- -- -- -- -- -- -- -- -- -- -- -- -- -- -- -- -- -- -- -- -- -- -- -- -- -- -- -- -- -- -- -- -- -- -- -- -- -- -- -- -- -- -- -- -- -- 
-- -- -- -- -- -- -- -- -- -- -- -- -- -- -- -- -- -- -- -- -- -- -- -- -- -- -- -- -- -- -- -- -- -- -- -- -- -- -- -- -- -- -- -- -- -- -- -- 
-- -- -- -- -- -- -- -- -- -- -- -- -- -- -- -- -- -- -- -- -- -- -- -- -- -- -- -- -- -- -- -- -- -- -- -- -- -- -- -- -- -- -- -- -- -- -- -- 
-- -- -- -- -- -- -- -- -- -- -- -- -- -- -- -- -- -- -- -- -- -- -- -- -- -- -- -- -- -- -- -- -- -- -- -- -- -- -- -- -- -- -- -- -- -- -- -- 
end-item